21 Jump Street	Action, Comedy, Crime
30 Minutes or Less	Action, Comedy, Crime
The 40-Year-Old Virgin	Comedy, Romance
500DAYSOFSUMMER	N/A
Abraham Lincoln Vampire Hunter: The Great Calamity	Animation, Short, Fantasy
A Good Day to Die Hard	Action, Crime, Thriller
A Thousand Words	Comedy, Drama
Bad Teacher	Comedy
Bruno	Comedy, Drama
Burlesque	Drama, Music, Romance
Captain America	Action, Sci-Fi, Thriller
Chasing Mavericks	Biography, Drama, Sport
Chronicle	Drama, Sci-Fi, Thriller
Cinderella Man	Biography, Drama, Sport
Colombiana	Action, Crime, Drama
Dear John	Drama, Romance, War
Dinner for Schmucks	Comedy
District 9	Action, Sci-Fi, Thriller
Easy A	Comedy, Romance
Flight	Drama, Thriller
Get Him to the Greek	Comedy, Music
Ghost Rider: Spirit of Vengeance	Action, Fantasy, Thriller
Green Zone	Action, Drama, Thriller
Grown Ups	Comedy
Hugo	Adventure, Drama, Family
In Time	Action, Sci-Fi, Thriller
Iron Man 2	Action, Adventure, Sci-Fi
ITS COMPLICATED	N/A
JULIE AND JULIA	N/A
Just Go with It	Comedy, Romance
Karate Kid	Action, Sport
Katy Perry: Part of Me	Documentary, Music
Knocked Up	Comedy, Drama, Romance
Land of the Lost	Adventure, Comedy, Sci-Fi
Larry Crowne	Comedy, Drama, Romance
Life of Pi	Adventure, Drama, Fantasy
Little Fockers	Comedy, Romance
Morning Glory	Comedy, Drama, Romance
MR POPPERS PENGUINS	N/A
Nanny McPhee Returns	Comedy, Family, Fantasy
No Strings Attached	Comedy, Romance
Parental Guidance	Comedy, Family
PERCY JACKSON LIGHTENING THIEF	N/A
Prometheus	Adventure, Mystery, Sci-Fi
Robin Hood	Action, Adventure, Drama
Ruby Sparks	Comedy, Drama, Fantasy
Salt	Action, Crime, Mystery
Sanctum	Adventure, Drama, Thriller
SNOW FLOWER FD	N/A
SORCERERS APPRENTICE	N/A
Soul Surfer	Biography, Drama, Sport
Super 8	Mystery, Sci-Fi, Thriller
The Adventures of Tintin	Animation, Action, Adventure
The Art of Getting By	Drama, Romance
The Call	Crime, Thriller
The Girl with the Dragon Tattoo	Crime, Drama, Mystery
The Guilt Trip	Comedy, Drama
The Sitter	Comedy
The Social Network	Biography, Drama
The Vow	Drama, Romance
The Watch	Action, Comedy, Sci-Fi
Think Like a Man	Comedy, Romance
This Means War	Action, Comedy, Romance
Thor	Action, Adventure, Fantasy
Tooth Fairy	Comedy, Family, Fantasy
True Grit	Adventure, Drama, Western
We Bought a Zoo	Comedy, Drama, Family
WHATS YOUR NUMBER	N/A
XMEN FIRST CLASS	N/A
Young Adult	Comedy, Drama
Zombieland	Adventure, Comedy, Horror
Zookeeper	Comedy, Family, Romance
Battle Los Angeles	Action, Sci-Fi
Charlie St Cloud T4 Movie Special	N/A
Death at a Funeral	Comedy
Hansel & Gretel: Witch Hunters	Action, Fantasy, Horror
How Do You Know	Comedy, Drama, Romance
The Ides of March	Drama
The Big Year	Comedy
The Roommate	Drama, Horror, Thriller
TITANIC 1	N/A
TITANIC 2	N/A
Can't Wait for the Movies: Big Mommas Like Father Like Son	Short, Comedy
BLINDDATING	N/A
Friends with Benefits	Comedy, Romance
Inside Man	Crime, Drama, Mystery
Jack and Jill	Comedy
Public Enemies	Biography, Crime, Drama
SPARKLE 2012	N/A
The Bounty Hunter	Action, Comedy, Romance
The Descendants	Comedy, Drama
The Ugly Truth	Comedy, Romance